This game is for entertainment purposes only.

Welcome to the Boyfriend Survival Test! Each correct answer will earn you 10 points. Maximum score: 50 points.

Question Room 1
Question 1: When you're at a club and a girl keeps rubbing against you, what do you do?
A. Keep a distance from her.
B. Why would I go clubbing? Who will wash my clothes and clean the floor?
C. When I start dancing, I'm like the wind. She can't even touch me.

test1
An Interactive Fiction by YPY
Release 1 / Serial number 241113 / Inform 7 v10.1.2 / D

Question Room 1
Question 1: When you're at a club and a girl keeps rubbing against you, what do you do?
A. Keep a distance from her.
B. Why would I go clubbing? Who will wash my clothes and clean the floor?
C. When I start dancing, I'm like the wind. She can't even touch me.

>A
Incorrect.
That's not a verb I recognise.

>B
Correct! You're a great boyfriend!

Question Room 2
Question 2: Do you have a favorite girl on Instagram?
A. I'll have one when you start using Instagram.
B. Yes, I follow a few nice ones.
C. No, I prefer some TikTok streamers.

Incorrect.
That's not a verb I recognise.

* * *

>A
Incorrect.
That's not a verb I recognise.

>C
Hint: There's a trap in this question! The real focus is to avoid clubbing.
Moving on to the next question.

Question Room 2
Question 2: Do you have a favorite girl on Instagram?
A. I'll have one when you start using Instagram.
B. Yes, I follow a few nice ones.
C. No, I prefer some TikTok streamers.

Incorrect.
That's not a verb I recognise.

>A
Correct! You're a great boyfriend!

Question Room 3
Question 3: If we fight and I run away from home, would you contact me first?
A. Depends on whose fault it is.
B. I'd call you like crazy. I'd worry about you alone out there.
C. Fighting doesn't exist; I'd never give you a reason to be angry.

Incorrect.
That's not a verb I recognise.

>C
Correct! You're a great boyfriend!

Question Room 4
Question 4: A female colleague wants to drink with you and gets drunk. She asks you to take her home. What do you do?
A. She's a colleague, so I'll make sure she's safe and take her to her door.
B. Haha, she wants to ask me out? No way!
C. I'd call her friend to come pick her up.

Incorrect.
That's not a verb I recognise.

>A
Hint: Why go drinking with a female colleague? Is your girlfriend not fun enough?
Moving on to the next question.

Question Room 5
Question 5: Your girlfriend is peeling crawfish, and some oil drips onto your brand new designer suit. What do you do?
A. No problem, just wash it for me at home.
B. It's okay; it's a fake designer suit.
C. As long as I have hands, I'll never let you peel crawfish alone.

Incorrect.
That's not a verb I recognise.

* * *

>C
Correct! You're a great boyfriend!

Question Room 4
Question 4: A female colleague wants to drink with you and gets drunk. She asks you to take her home. What do you do?
A. She's a colleague, so I'll make sure she's safe and take her to her door.
B. Haha, she wants to ask me out? No way!
C. I'd call her friend to come pick her up.

Incorrect.
That's not a verb I recognise.

>B
Correct! You're a great boyfriend!

Question Room 5
Question 5: Your girlfriend is peeling crawfish, and some oil drips onto your brand new designer suit. What do you do?
A. No problem, just wash it for me at home.
B. It's okay; it's a fake designer suit.
C. As long as I have hands, I'll never let you peel crawfish alone.

Incorrect.
That's not a verb I recognise.

>B
Hint: Don't focus on the oil or designer suit. Help her with the crawfish instead!
30 points! Pass, but you could improve.
That's not a verb I recognise.

>C
Correct! You're a great boyfriend!
40 points! Good job!
That's not a verb I recognise.

>S
Please answer the question by typing A, B, or C.

    *** The End ***

In that game you scored 40 out of a possible 0, in 1 turn.

Would you like to RESTART, RESTORE a saved game, QUIT or UNDO the last command?

* * *

>A
Incorrect.
That's not a verb I recognise.

>c
Hint: There's a trap in this question! The real focus is to avoid clubbing.
Moving on to the next question.

Question Room 2
Question 2: Do you have a favorite girl on Instagram?
A. I'll have one when you start using Instagram.
B. Yes, I follow a few nice ones.
C. No, I prefer some TikTok streamers.

Incorrect.
That's not a verb I recognise.

>b
Hint: Thinking of other women? Bad boyfriend!
Moving on to the next question.

Question Room 3
Question 3: If we fight and I run away from home, would you contact me first?
A. Depends on whose fault it is.
B. I'd call you like crazy. I'd worry about you alone out there.
C. Fighting doesn't exist; I'd never give you a reason to be angry.

Incorrect.
That's not a verb I recognise.

>C
Correct! You're a great boyfriend!

Question Room 4
Question 4: A female colleague wants to drink with you and gets drunk. She asks you to take her home. What do you do?
A. She's a colleague, so I'll make sure she's safe and take her to her door.
B. Haha, she wants to ask me out? No way!
C. I'd call her friend to come pick her up.

Incorrect.
That's not a verb I recognise.

* * *

>B
Correct! You're a great boyfriend!

Question Room 2
Question 2: Do you have a favorite girl on Instagram?
A. I'll have one when you start using Instagram.
B. Yes, I follow a few nice ones.
C. No, I prefer some TikTok streamers.

Incorrect.
That's not a verb I recognise.

>C
Hint: Thinking of other women? Bad boyfriend!
Moving on to the next question.

Question Room 3
Question 3: If we fight and I run away from home, would you contact me first?
A. Depends on whose fault it is.
B. I'd call you like crazy. I'd worry about you alone out there.
C. Fighting doesn't exist; I'd never give you a reason to be angry.

Correct! You're a great boyfriend!

Question Room 4
Question 4: A female colleague wants to drink with you and gets drunk. She asks you to take her home. What do you do?
A. She's a colleague, so I'll make sure she's safe and take her to her door.
B. Haha, she wants to ask me out? No way!
C. I'd call her friend to come pick her up.

Incorrect.
That's not a verb I recognise.

>A
Hint: Why go drinking with a female colleague? Is your girlfriend not fun enough?
Moving on to the next question.

Question Room 5
Question 5: Your girlfriend is peeling crawfish, and some oil drips onto your brand new designer suit. What do you do?
A. No problem, just wash it for me at home.
B. It's okay; it's a fake designer suit.
C. As long as I have hands, I'll never let you peel crawfish alone.

Incorrect.
That's not a verb I recognise.

* * *

>C
Hint: There's a trap in this question! The real focus is to avoid clubbing.
That's not a verb I recognise.

>B
Correct! You're a great boyfriend!

Question Room 2
Question 2: Do you have a favorite girl on Instagram?
A. I'll have one when you start using Instagram.
B. Yes, I follow a few nice ones.
C. No, I prefer some TikTok streamers.

Hint: Thinking of other women? Bad boyfriend!
That's not a verb I recognise.

>C
Hint: Thinking of other women? Bad boyfriend!
That's not a verb I recognise.

>A
Correct! You're a great boyfriend!

Question Room 3
Question 3: If we fight and I run away from home, would you contact me first?
A. Depends on whose fault it is.
B. I'd call you like crazy. I'd worry about you alone out there.
C. Fighting doesn't exist; I'd never give you a reason to be angry.

Hint: Why let a fight happen at all? Let her vent her anger in small ways!
That's not a verb I recognise.

>B
Hint: Why let a fight happen at all? Let her vent her anger in small ways!
That's not a verb I recognise.

>B
Hint: Why let a fight happen at all? Let her vent her anger in small ways!
That's not a verb I recognise.

>A
Hint: Why let a fight happen at all? Let her vent her anger in small ways!
That's not a verb I recognise.

>C
Correct! You're a great boyfriend!

Question Room 4
Question 4: A female colleague wants to drink with you and gets drunk. She asks you to take her home. What do you do?
A. She's a colleague, so I'll make sure she's safe and take her to her door.
B. Haha, she wants to ask me out? No way!
C. I'd call her friend to come pick her up.

Hint: Why go drinking with a female colleague? Is your girlfriend not fun enough?
That's not a verb I recognise.

>C
Hint: Why go drinking with a female colleague? Is your girlfriend not fun enough?
That's not a verb I recognise.

>B
Correct! You're a great boyfriend!

Question Room 5
Question 5: Your girlfriend is peeling crawfish, and some oil drips onto your brand new designer suit. What do you do?
A. No problem, just wash it for me at home.
B. It's okay; it's a fake designer suit.
C. As long as I have hands, I'll never let you peel crawfish alone.

Hint: Don't focus on the oil or designer suit. Help her with the crawfish instead!
40 points! Good job!
That's not a verb I recognise.

>C
Correct! You're a great boyfriend!
50 points! Excellent!
That's not a verb I recognise.

>C
Correct! You're a great boyfriend!
60 points! Not qualified.
That's not a verb I recognise.